11111111111111111111
10010000000C11111101
10000111110000011101
1P0011E0000011000001
11111111111111111111