11111111111111111111
10010C00000C111C00C1
10000111110000011011
1P0C11E0000C11000001
11111111111111111111