1111111111111
1P0000C000E01
1111111111111